NO assets/rusts.xpm
SO assets/pavingstone.xpm
WE assets/rockwall.xpm
EA assets/tux.xpm
F 184, 178, 179
C 167, 242, 240

11111
11011
10N01
10101
11111
