NO assets/rusts.xpm
SO assets/pavingstone.xpm
WE assets/rockwall.xpm
EA assets/tux.xpm
F 184, 178, 179
C 167, 242, 240

11111111
10000001
10P00001
10000N01
10000001
11111111
