NO assets/rusts.xpm
SO     assets/rusts.xpm     
WE assets/rusts.xpm
EA assets/rusts.xpm
F 162, 166, 159
C 165, 230, 227

111111
110101
100001
10S001
110011
111111




