NO assets/brick.xpm
SO assets/rusts.xpm
WE assets/rusts.xpm
EA assets/rusts.xpm
F 184, 178, 179
C 167, 242, 240

1111111
1000101
1000001     
110N001
1111111
