NO assets/rusts.xpm
SO     assets/rusts.xpm     
WE assets/rusts.xpm
EA assets/rusts.xpm
F 220,100,0 
C 225,30,0

111111
100101
100001
100001
100N11
111111




