NO assets/pavingstone.xpm
SO assets/rusts.xpm
WE assets/rusts.xpm
EA assets/rusts.xpm
F  21 ,   100 , 8
C 244  ,  128  ,  32 
111111
100101
101001
1100N1
111111
