NO assets/pavingstone.xpm
SO assets/rusts.xpm
WE assets/rusts.xpm
EA assets/rusts.xpm
F  21 ,   100 , 8
C 244  ,  128  ,  32 
111111
100001
10000D
1000N1
111111
